+-+-+-+-+-+-+-+-+-+-+-+-+-+-+-+-+-+-+-+-+-+-+-+-+-+-+-+-+-+-+-+-+-+-+-+-+-+-+-+-+
      | | |   |       |     | | | |     |   | |   |   | |       |     |         |
+ + + + + + +-+ +-+-+-+ +-+-+ + + + +-+-+ + + + +-+-+ + +-+ +-+-+-+-+ +-+-+-+ +-+
| | |               |     |   |     |     | |   | | |   | | |       |       |   |
+-+-+ +-+ +-+-+-+-+ + +-+ +-+ + + +-+ + +-+-+ +-+ + + +-+ + + +-+-+ + +-+-+ +-+ +
| | | | |         |   |         |   | |   |         | |       |         |       |
+ + +-+ + +-+ + +-+-+ +-+-+-+ +-+-+ +-+ + +-+-+ +-+-+ +-+-+ + +-+ +-+ +-+-+-+ +-+
|     |   |   |   |   |   |       |   | | |   | |     | |   | |   |   |   | |   |
+ +-+ +-+ +-+ + +-+-+ + +-+ +-+-+-+ +-+ +-+-+ + + +-+ + + +-+ +-+-+ +-+-+ + +-+ +
|   |   |   | |     |   |     |     |   | |   |     |     |   | |     |       | |
+-+-+ + + +-+ +-+ + +-+ +-+-+-+-+ +-+ +-+ +-+ +-+ + +-+-+ +-+ + +-+-+-+ +-+-+-+-+
|     | | |   | | |   |     | |       |           |   |   | |   | |             |
+-+ +-+-+-+-+ + +-+ + +-+ +-+ + + +-+ +-+ +-+-+ +-+ + +-+ + +-+ + +-+-+-+ + +-+ +
|   | | |   | |     | | |   | | |   | |     |     | | |       |   | |   | | |   |
+-+ + + + + + +-+-+-+ + +-+-+ +-+ +-+-+-+ +-+-+ +-+-+-+ +-+-+-+ +-+ +-+ + +-+ + +
|   |     |   | | |   |   | |   | | |     |     |         |     | | |       | | |
+-+ +-+ +-+-+ + + +-+ + + + + + +-+ +-+-+ +-+ +-+-+ +-+-+-+ + +-+ + + + +-+ + + +
|   | | |   |       | | |   | | |   | | | |     |   |   |   |   | | | | | | | | |
+ + + +-+ +-+ +-+-+-+-+-+ +-+-+ + + + + +-+ + +-+-+-+-+ + +-+-+ + + +-+ + +-+-+-+
| |     |       |         |       |         |   | | |   |     |   |         | | |
+ +-+-+ +-+ +-+-+ +-+ +-+-+-+ + +-+ + +-+-+-+-+-+ + +-+ +-+-+-+ +-+-+ +-+-+-+ + +
| |   | |       |   |         |   | |     |   |     | |   |             |   |   |
+-+ +-+ + +-+ +-+-+ + +-+-+-+-+-+ +-+-+ +-+-+ + + + + + +-+ +-+ +-+-+-+ + +-+ +-+
| |       |         |       |       | |   | |   | | |   |   | |   | |   | |     |
+ + +-+ +-+-+ +-+ +-+-+ +-+-+-+ +-+-+ + + + + + +-+ + + +-+ + +-+ + +-+-+ + +-+-+
|   | | | |   |   |     | |         |   |     | | | | |       |   |     | |     |
+-+ + + + + +-+-+-+-+ + + + +-+-+-+-+-+ +-+ + +-+ +-+ +-+ +-+-+-+ + +-+-+ + + +-+
|   | | | | |     |   |   |       |     |   | |   |     |   |           |   |   |
+-+-+ + + + +-+ +-+ + + +-+ + +-+ +-+ +-+ + +-+-+ + +-+ +-+-+ +-+ +-+-+ + +-+ + +
|       | | |       | |   | | |   |   | | |   |     |   | |   |     | |   | | | |
+-+-+-+ + +-+-+ + + +-+-+-+ +-+-+ +-+-+ +-+-+ + + +-+-+-+ +-+-+-+-+ + +-+-+ +-+ +
|   |     | |   | | |   |   |   | |     | |   | |         | |   |       |     | |
+-+ +-+-+ + + +-+-+-+-+ + +-+ +-+ +-+ + + +-+ +-+ +-+ +-+ + + + +-+-+-+-+-+ +-+ +
|   | |     |     |           | |   | |   | |   | | | |   | | |     | |   | | | |
+ + + + + +-+ + + +-+ + + + + + +-+-+-+-+ + +-+ + + + +-+-+ +-+ + +-+ + + + + +-+
| |     | | | | | |   | | | |   |   |           | |     |       |       | |     |
+-+-+-+-+ + + + + +-+-+-+ + + + + +-+-+ +-+-+ + +-+-+-+ +-+ +-+-+-+-+-+-+ + + +-+
|   |       | | |     |   | | |     |   |     | | |     |     |       |     |   |
+ + + +-+-+-+ +-+-+ + +-+ +-+ + + + +-+ +-+-+ +-+ + +-+ +-+ + + +-+ +-+ +-+-+-+ +
| |     |       |   | |   |   | | | |       |     |   |     |   |     | |        
+-+-+-+-+-+-+-+-+-+-+-+-+-+-+-+-+-+-+-+-+-+-+-+-+-+-+-+-+-+-+-+-+-+-+-+-+-+-+-+-+
