+-+-+-+-+-+-+-+-+-+-+-+-+-+-+
    |   |   |   |       | | |
+-+ +-+ +-+ + +-+-+ + +-+ + +
| | |       |       |   |   |
+ + + +-+ +-+ + +-+-+ + +-+ +
|   | |     | |     | | | | |
+-+ + +-+ +-+-+ +-+-+-+-+ + +
| |     |     | |       |   |
+ + + + + +-+-+ + +-+ +-+ + +
| | | | | |   |   |     | | |
+ + + +-+-+ + +-+-+ +-+ +-+ +
|   |   | | |     |   |     |
+-+ +-+-+ +-+ +-+ +-+-+-+-+ +
|       |     |       |     |
+ +-+-+ + +-+ +-+ + +-+ +-+ +
|   | |     | |   |   | |   |
+-+ + +-+ +-+ +-+-+ +-+ + + +
|     |     |     |     | | |
+-+ +-+ +-+-+-+ +-+ +-+ +-+ +
| |   |     |     | | |   | |
+ +-+-+-+ +-+-+ +-+ + +-+ + +
|       |   |   |     |   | |
+-+ + + +-+ +-+ +-+-+-+ + + +
|   | |       |   | |   | | |
+-+ +-+ +-+-+-+-+ + +-+ +-+-+
|   |         |   | |       |
+ +-+-+-+ + +-+-+ + +-+-+ +-+
|   |   | |   |       |     |
+-+ + +-+-+-+-+-+ + +-+-+ +-+
|   |   | | |     | |       |
+ + + +-+ + +-+ +-+-+ + + +-+
| |     |         |   | |    
+-+-+-+-+-+-+-+-+-+-+-+-+-+-+
