+-+-+-+-+-+-+-+-+-+-+-+-+-+-+-+
  |     |     | | | | | | |   |
+ + +-+ +-+ + + + + + + + + +-+
|   |   | | | | | | | |     | |
+ + +-+ + + +-+ + + + + +-+-+ +
| | |           |             |
+-+-+-+ +-+ + + +-+-+-+-+-+ +-+
|     | | | | | |   |     | | |
+ + + + + +-+ +-+-+ + + +-+ + +
| | |   |   |   |     | |     |
+-+ +-+-+ +-+-+ +-+ +-+ + +-+ +
|   |   |         | |   | | | |
+ +-+ + +-+ +-+-+-+ + +-+-+ + +
| | | | |   |     | | |       |
+-+ +-+ +-+ +-+ +-+-+ +-+ +-+ +
|       | |       |       |   |
+ +-+ + + + + + + + + + +-+ + +
|   | |   | | | |   | | | | | |
+-+-+-+ +-+ +-+-+ +-+-+-+ +-+ +
|   |   | |   | |     |     | |
+ + + + + + +-+ +-+-+-+-+-+ + +
| |   | |   |   |     |     | |
+-+-+-+ + + + +-+ +-+-+ +-+ +-+
|   |   | |   | | |   | |     |
+-+ +-+ +-+ +-+ + +-+ + +-+ + +
|     |   | |   | |     |   | |
+-+-+ + +-+ + + + + + +-+-+ +-+
|         |   |     | |   |   |
+ +-+ +-+ +-+ + +-+ + +-+ +-+ +
| | | | | | | | |   |     |   |
+-+ + + +-+ + +-+ + +-+-+-+-+ +
|     |         | |       |   |
+ +-+ + + + +-+ + +-+-+-+-+-+-+
|   |   | | | | |     | |   | |
+-+-+-+ +-+-+ + + +-+-+ +-+ + +
| |   |   |   | | | |         |
+ +-+ + + + +-+ + + +-+-+-+ + +
|     | |     | | |     | | | |
+-+-+ +-+-+-+ +-+-+-+-+ + + +-+
|   |     |     |       |   | |
+ + +-+ +-+-+ + +-+ +-+-+-+ + +
| |     |     | |     | |   | |
+-+-+ +-+ +-+ +-+ +-+-+ + +-+ +
|     | | |   | |       |     |
+ +-+-+ + +-+ + +-+ +-+-+ + +-+
|       | | |       |     |   |
+ + + +-+ + +-+ + + +-+ +-+ + +
| | |   | |     | |     |   | |
+-+ + + +-+-+-+ +-+-+-+-+-+-+ +
|   | |     |     | |   | |   |
+-+-+ + +-+-+ +-+-+ + + + +-+ +
| | | | |           | | | |   |
+ + +-+ +-+ +-+ +-+ + +-+ + +-+
|     |   |   | |   | |       |
+ + +-+ + + +-+-+ +-+ +-+ +-+ +
| |     |     |   |   |     | |
+-+ + + +-+-+-+-+ + + + + +-+-+
| | | |   | |       | | |     |
+ + + +-+-+ + + + +-+ +-+ + +-+
|   | |       | |   | |   |    
+-+-+-+-+-+-+-+-+-+-+-+-+-+-+-+
