+-+-+-+-+-+-+-+-+-+-+
            |       |
+-+-+-+ +-+-+-+-+ + +
| | |       |     | |
+ + +-+ +-+ +-+ +-+ +
|     | | | |   |   |
+ +-+ + + + +-+-+-+ +
|   |   | |     |   |
+ + +-+ + + +-+-+ +-+
| |   | |       | | |
+-+-+-+-+-+-+ +-+ + +
| |         | |     |
+ + + + + + + +-+ + +
| | | | | | |     | |
+ + + + + +-+ +-+ + +
| | | | |     |   | |
+ + +-+-+ + +-+ + +-+
|       | |   | | | |
+-+ +-+-+-+-+-+-+ + +
|       |            
+-+-+-+-+-+-+-+-+-+-+
